X  S       X         X
X    X     X         X
X    X               X
X    X     X         X
X    X     X         X
X    X               X
X    X     X        GX