+--+--+--+--+--+--+--+--+--+--+--+--+--+--+--+--+--+--+--+--+
      |        |           |                       |        |
+--+  +  +--+  +  +--+--+  +--+--+--+--+  +--+--+  +  +--+  +
|     |  |     |     |  |     |        |  |     |     |  |  |
+  +--+  +  +--+--+  +  +--+  +  +--+  +  +  +  +  +  +  +  +
|  |  |  |  |        |     |  |     |  |     |  |  |  |     |
+  +  +  +  +  +  +--+--+  +  +--+  +  +--+--+  +--+  +--+--+
|     |  |  |  |  |     |  |     |  |  |        |           |
+--+  +  +  +--+  +  +  +  +--+  +  +  +--+--+--+  +--+--+--+
|  |  |  |  |     |  |  |  |     |  |           |  |        |
+  +  +  +  +  +--+--+  +  +  +--+--+--+--+--+  +  +  +--+  +
|  |     |     |     |  |  |        |     |        |  |     |
+G +--+  +--+--+  +  +  +  +--+--+  +  +  +  +  +--+  +  +--+
|        |        |     |  |     |  |  |     |  |     |  |  |
+--+--+--+  +--+--+--+--+  +  +--+  +  +--+--+  +  +  +  +  +
|        |     |           |     |  |  |        |  |  |     |
+  +--+  +--+  +--+  +--+--+--+  +  +--+  +--+--+  +--+  +--+
|  |  |     |     |     |     |           |     |     |     |
+  +  +--+  +--+  +--+  +  +  +--+  +--+--+  +  +--+  +  +  +
|        |  |        |     |  |              |        |  |  |
+  +--+--+  +  +--+  +--+--+  +  +  +--+--+--+--+--+--+--+  +
|  |     |  |  |                 |  |           |           |
+  +  +  +  +--+  +--+--+--+  +--+  +--+--+--+  +--+--+--+  +
|     |  |        |        |  |     |                       |
+--+--+  +--+--+--+  +--+  +  +--+--+  +--+--+--+--+--+--+--+
|     |           |  |  |           |  |                 |  |
+--+  +  +--+--+--+  +  +--+--+--+  +  +  +--+  +--+  +  +  +
|     |  |        |     |           |  |     |  |     |     |
+  +--+  +  +--+  +  +--+  +--+  +--+  +--+--+  +  +--+--+--+
|        |     |  |     |  |  |     |  |     |  |  |  |     |
+--+--+--+--+  +  +--+--+  +  +--+  +  +  +  +  +  +  +  +  +
|           |  |           |        |  |  |     |     |  |  |
+  +--+  +--+  +  +--+--+--+--+--+--+  +  +--+--+--+  +  +  +
|     |        |  |        |     |     |  |           |  |  |
+--+  +--+--+--+  +  +  +--+  +  +  +--+  +  +--+--+  +--+  +
|           |  |     |     |  |  |     |  |        |        |
+  +--+--+  +  +--+--+--+  +  +--+--+  +  +--+  +  +--+--+--+
|  |     |     |     |     |  |     |     |  |  |     |     |
+  +--+  +--+  +  +  +  +--+  +  +  +--+--+  +  +--+  +  +  +
|        |        |  |     |     |              |        |  S
+--+--+--+--+--+--+--+--+--+--+--+--+--+--+--+--+--+--+--+--+