+-+-+-+-+-+-+-+-+-+-+-+-+-+-+-+-+-+-+-+-+-+-+-+-+-+-+-+-+-+-+-+-+-+-+-+-+-+-+-+-+-+-+-+-+-+-+-+-+-+-+
  |       |     |     |     |       |   | |   |   |         |     |   |   |               |     |   |
+ +-+-+ +-+ + +-+ +-+ + +-+ + +-+-+ +-+ + + +-+ + + +-+-+-+ + +-+ +-+ + +-+ + +-+-+-+-+ + +-+-+ + + +
|       |   |   |   |   |   |     |   |   |     |   |     | | |   |     |   |   |       |   |   | | |
+ +-+ +-+ +-+ + +-+ +-+-+ +-+-+-+-+-+ +-+ +-+-+ +-+-+ + +-+ + + +-+ + +-+ +-+-+ + +-+-+-+-+ + +-+-+ +
| |   |   |   |   | |     |     |     | | |   | |   | |     | |   | | |   |     |   |     | |       |
+ +-+-+ +-+ +-+-+ + + +-+ + +-+ + +-+-+ + + + + +-+ + +-+-+-+ +-+ + + + +-+-+-+-+-+ + +-+ + + +-+-+ +
| |   |   |     | | |   | | | | |       | | | |   | | |       |   | | |     |   |   |   | | | |     |
+ + + +-+-+ +-+ + + +-+ +-+ + + +-+ +-+-+ + + +-+ + + + +-+-+-+ +-+ +-+-+-+ + + + +-+-+-+ + + + +-+-+
|   |     |   | | | |   |     |   |     | | |   | | |   | |   | |           | | |       | |   | |   |
+-+-+-+-+ + + +-+ + + +-+ +-+-+-+ + +-+ + + +-+ + + +-+-+ + + + + + +-+-+ +-+ + +-+-+-+ + +-+-+ + + +
| |     |   | |   | |     |       |   | | |   | | |   |   | | |   | |   |     | | |     | |   |   | |
+ + +-+ +-+-+-+ +-+ +-+-+-+ +-+-+-+-+ + + +-+ +-+ +-+ + +-+ +-+-+-+ + + +-+ +-+ + + +-+-+ + + +-+-+ +
| | | |       | |   |       |   |   | |         | | | |   |         | |     |   | |   |   | |       |
+ + + +-+ +-+ + + +-+ +-+-+-+-+ + + + +-+ +-+-+ + + + +-+ +-+-+-+-+-+ +-+-+-+ +-+ +-+ + +-+ +-+-+-+-+
|   |   | |   | | |   |   |     | | |   | |   |   |   |   |       |     |   |   | |     |         | |
+-+-+ + +-+ + + + + +-+ + + + +-+ +-+-+ + + + +-+-+ +-+ +-+ +-+-+ + +-+ +-+ +-+ + + +-+-+-+ + +-+ + +
|   | |   | | |   |     |   | |   |     |   | |     |   |   |       |   |   | | | |   |     |   |   |
+ + + +-+ + + +-+-+ +-+-+-+-+ + +-+ +-+-+-+-+ + +-+-+ +-+-+-+-+-+ + + +-+ +-+ + + +-+ + +-+-+-+ +-+-+
| | | | |   |     |   |   |   | |       |   | | |   |         |   | |   | |     | |   | |   |   |   |
+ + + + +-+-+-+-+-+-+ + +-+ +-+ +-+-+-+ + + + + +-+ +-+ +-+-+ +-+-+-+-+ + + +-+-+ +-+-+ + +-+ +-+ + +
| | | |   |         | |       |   |     | |   | |   | |     | |         | |       |     |     | | | |
+ + + +-+ + + +-+-+ + +-+-+-+-+-+ + +-+-+ +-+-+ + +-+ +-+-+ +-+ +-+-+ +-+ +-+-+ +-+ +-+-+ +-+-+ + +-+
| | |   |   |     |   |         |   |   |   |   |     |       |   | |     |   | |   |   | |   | |   |
+ + +-+ +-+-+-+-+-+-+ + +-+-+-+ + +-+-+ +-+ + +-+-+ +-+-+-+-+ +-+ + + +-+-+-+ + +-+-+-+ + + + + +-+ +
| |   |         |       |     |   |       |   |   |   |     |     |   |   |   |         | | | | | | |
+ +-+ +-+-+-+-+ + +-+ +-+ +-+ +-+-+ +-+ + +-+-+ + +-+ + +-+ +-+-+-+-+-+ + + +-+ + +-+-+-+ +-+ + + + +
| |   | |     | |   |   | | | |   | |   | |     | | |   |   |   |       | |   | |       |   |   |   |
+ +-+-+ + +-+ + +-+ +-+ + + + + + + + +-+ +-+-+-+ + +-+-+ +-+-+ + + +-+-+ +-+ +-+ +-+-+ +-+ + +-+ +-+
|       | |   | |   | |   |     |   | |   |     | |     | |   | | |   |   | |     |   | |   |       |
+ +-+ + + + +-+ + +-+ +-+-+-+ +-+-+-+ + +-+ +-+ + +-+ +-+ + + + +-+-+ + +-+ +-+ +-+ + + + +-+-+-+ + +
| |   |   |   |   |     |     |     | |     |   |   | |   | | |       |   | |   |   | | | |       | |
+ + +-+-+-+-+ +-+-+ + +-+ +-+-+ + +-+ +-+-+-+ +-+-+ + + +-+-+ + +-+ +-+-+ + + + + + +-+ + + +-+-+-+ +
| |     |   |     | | |   |     |   |       |     | |   |       | | |   |   | | | |     | | |       |
+ +-+-+ + + +-+-+ +-+ + +-+ +-+-+-+ +-+-+-+ +-+-+ + + +-+ +-+ +-+ + + +-+-+-+ + + +-+-+-+ + +-+ +-+-+
| |     | | |   |     |   | |   | |         |       | |   |   | |   |         | | |   |   |   |   | |
+-+ +-+-+-+ +-+ +-+-+ +-+ + + + + +-+ +-+-+-+ +-+ +-+ + +-+-+-+ +-+-+-+-+-+-+-+-+ + + + +-+-+ + + + +
|           |   |   |     | | | | | | |     |   |     |   |         |         |   | | |       | | | |
+ +-+-+-+-+ + +-+-+ +-+-+-+ +-+ + + + +-+-+ +-+ +-+-+-+-+ + +-+-+-+ + +-+-+ +-+ +-+ +-+-+-+-+-+ + + +
|   |     | | |     |     |     | | |       | |   | |     | |     | |   | |       |             |   |
+-+ + +-+ +-+ + +-+-+ +-+ +-+-+-+ + +-+-+ + + +-+ + + +-+ + +-+-+ + +-+ + +-+-+-+ +-+-+-+-+-+-+-+-+ +
|   | | |     | |   |   | |   | |   G     | | | | |     | |   |   |   |   |     |   | |   | |       |
+ + + + +-+-+ + + +-+-+ + +-+ + +-+-+-+-+ +-+ + + +-+-+-+ +-+ + +-+-+ +-+-+ +-+ +-+ + + + + + +-+-+-+
| | | | |   |     |     |     | |       | |     | |     | |   |     | |   |   | |   | | |   | | |   |
+ + + + + +-+-+-+-+ +-+ +-+-+-+ + +-+ + +-+ + + + +-+-+ + + +-+-+-+ + +-+ +-+ + +-+-+ + +-+-+ + + + +
| |   | |   |       | |     |   |   | | |   | |     | | |   |   |   |   | |   |   |   |     | |   | |
+ +-+-+ +-+ + +-+-+ + +-+-+ + +-+-+-+ + + +-+ +-+-+ + + + +-+ + + +-+-+ + + +-+ + + +-+-+-+ + +-+-+ +
| |       |   |   |   |           |   | | | | |   |     |   | | |       | | |   | | |     | |     | |
+ + +-+-+ +-+-+ + +-+-+ +-+-+ +-+ + +-+-+ + + + + +-+ +-+-+ + +-+-+-+ +-+ + + +-+ + + + +-+ + +-+ + +
| | | |   |     | |     |   | |   |       |     | |     |   |   |     |   | | |   |   |     | | | | |
+ + + + +-+ +-+-+ + +-+-+ + + +-+-+-+-+-+-+-+-+-+ + +-+ +-+-+ + +-+ +-+ +-+ + + +-+-+ +-+-+-+ + + + +
|   |   |   |     |     | | |           |         | |   |   | | |     |   | | | |   | |   |   | |   |
+-+ + +-+-+-+ +-+-+-+-+ + +-+-+-+-+-+-+ + +-+-+-+-+ + +-+ + + + + +-+-+ + +-+ + +-+ + +-+ + +-+ +-+-+
|   | |       |   |   | | |     |     |   |     |   |     | | |   |   | |     |       |   | | |     |
+ +-+ + + +-+-+ + + + + + + +-+ + +-+-+-+-+ +-+ + +-+ +-+-+ + +-+-+ + + + +-+-+-+-+-+-+ + + + +-+ + +
|   |   |     | | | | | |   | | |     |   |   |     |     |   |   | |   | |           | | |       | |
+-+ +-+-+ +-+ + +-+ + + +-+ + + +-+-+ + + +-+ +-+-+-+-+-+ +-+-+ +-+ +-+-+-+ +-+-+-+-+ + + +-+-+-+-+ +
|   |   |   |   |   | |   |   |         |     |     |     |   |   |     |   | |     | | |     | |   |
+ +-+-+ +-+-+-+-+ + + +-+ +-+-+-+-+-+ + +-+-+-+ +-+ + +-+-+ +-+-+ + + +-+ +-+ + +-+-+ +-+-+-+ + + + +
|     |   |       | |   | |         | | |   |   | | |       |     | |   | |   |       |   |   | | | |
+-+-+ + +-+ +-+-+-+ +-+ +-+ +-+-+-+ + + +-+ + +-+ + +-+ +-+ + +-+-+-+-+ + + +-+-+ +-+-+ + + +-+ + + +
| |   |     |   |   | |     |   |     |     |     |   | |   |       |   | | |   | |     |     | | | |
+ + +-+-+-+-+ + + +-+ +-+-+-+-+ +-+ +-+-+-+-+-+-+-+-+ +-+ +-+ +-+-+ +-+ + + + +-+ + +-+-+-+-+ + + + +
| | |         |   |   |   |   |     | |       |     | |   |   |   | |     |   |   | |       |   | | |
+ + + + +-+-+-+-+-+ +-+ + + + +-+-+-+ + +-+-+ + +-+ + + +-+ +-+ + + + + +-+-+ + +-+ + +-+ + +-+-+ + +
| | | | | |   |   |     | | | |       |   | | | | | | |   |   | |   | | |   | |   |     | | |     | |
+ + +-+ + + + + + +-+ +-+ +-+ + +-+-+-+-+ + + + + + + +-+ +-+-+ +-+-+ + + +-+ +-+ +-+-+-+ + + +-+-+-+
| |   |     | | |   | |   |   |   |   | | |   | | | |     |     |     | |       |     |   | |       |
+ +-+ +-+-+-+ +-+-+ +-+ +-+ +-+-+ + + + + +-+-+ + + +-+ +-+ +-+-+ +-+-+ + +-+ +-+-+-+ + +-+-+-+-+-+ +
|   | |     |       |   | | |       |   | |     |       | |   |   |   | | |   |     | | |   |     | |
+ +-+ + +-+ + +-+-+-+ +-+ + +-+-+ +-+ +-+ +-+-+-+-+ +-+-+ +-+ +-+ + + + + + +-+ +-+ + + + + + +-+ + +
|     |   | |       | |   | |   |   | |       |   |   |       |   | |   | |   |   | |   | | |   | | |
+-+-+-+-+ +-+ +-+-+ + + +-+ + + +-+-+ +-+-+-+ +-+ +-+ +-+-+ +-+ +-+ +-+-+ +-+ + + +-+-+-+ +-+-+ + + +
|   |   |     |     |   |   | |     |     | |     |         |   |         | | | |   |   |       | | |
+ + + + +-+-+-+ +-+-+-+ + +-+ +-+-+ +-+-+ + +-+ +-+-+-+-+-+ + +-+ +-+-+-+-+ + +-+-+ +-+ +-+-+-+ + + +
| |   |         |   |   | | | |       |       |   |       | | |       |   | |           |       |   |
+ +-+-+-+-+-+-+-+ + + +-+ + + +-+-+ + + +-+-+-+ +-+ +-+-+ +-+ +-+-+-+ + + + +-+-+-+ +-+-+-+-+ + +-+-+
|     |     |     | |   |     |     | |     |   |   |   |   |     |   | | |     |   |         |     |
+-+-+ + +-+ + +-+ + +-+ +-+-+ + +-+-+-+ +-+ + +-+ +-+-+ +-+ +-+-+ + +-+ +-+-+ +-+ + + +-+-+-+-+-+-+ +
|   | | | |     | |   |     | | |     | |   |   | | |   | |       |         | |   | | |   |     |   |
+ + + + + + +-+ + +-+ +-+-+ +-+ + + + + + + + +-+ + + + + +-+-+-+-+-+-+ +-+-+ + +-+-+ + + + + + + +-+
| | |   |   |   | |   |     |   | | |   | | |   |     |   |     |     |       |   |   | |   | | |   |
+ +-+-+-+-+-+ +-+ + +-+ +-+-+ +-+ + +-+-+ +-+-+ +-+ +-+-+-+ +-+ + +-+ +-+-+-+-+-+ + +-+ +-+-+-+ +-+-+
|   |     |   | | |     |   | |   |   |   |     |   |     |   | |   | |   |   |   |         |   |   |
+-+ + +-+ + +-+ + +-+-+-+ + + + +-+-+ + +-+ +-+-+ +-+-+ + +-+-+ +-+ + + + + + + +-+-+-+-+-+ + +-+ + +
|   |   |   |   |     |   |   |   | | | |   |     |     |         | |   | | |   |       |   |   | | |
+ +-+-+ +-+ + +-+-+-+ + +-+-+-+-+ + + + + + + +-+-+ +-+-+-+-+-+-+ + +-+-+-+ +-+-+ +-+-+ +-+-+ + + + +
| |   |   |     |   |       |       | | | | |     |     |       | | |   |   |   |     | |     | | | |
+ + +-+ +-+-+-+-+ + + + + +-+ +-+-+-+ +-+ +-+-+-+ +-+ +-+ +-+-+ + + + +-+ +-+-+ + + + +-+ +-+-+ +-+ +
|   |   |       | |   | | |   |   |   |   |       |     |     | | | |     |     | | |     |     |   |
+-+ + +-+ +-+-+ + +-+-+ +-+ +-+ + + + + +-+ + +-+-+-+-+ +-+-+ + + + +-+-+ +-+ +-+ + +-+-+-+-+ +-+ +-+
| |   | | |   |   |     |   | | |   | |   | |   |     | |   | | | |     | |   | | |   |   |   |   | |
+ +-+-+ + + + + +-+-+-+-+ +-+ + + + + +-+ +-+-+ + +-+-+ + + +-+ +-+-+-+ + + +-+ + +-+ + + + +-+ +-+ +
|   |   |   | | |       | |     | | |     |       |     | | |       | | | |   | | |   | | | |   |   |
+ + + +-+-+ + +-+ +-+-+ + +-+-+-+-+ +-+ +-+ +-+ +-+-+ +-+-+ + + +-+ + + + +-+ + + + +-+ + + + +-+ +-+
| |         |   |     | |   |   |   |   |   |   |         |   |   |   | |     | | |   | | |   |     |
+ +-+-+-+-+-+ + +-+-+-+ +-+ + + + +-+ +-+-+ + +-+-+-+-+ + + +-+ + +-+-+ +-+ + + + +-+ +-+ +-+-+ +-+ +
| |     |   | |           | | | | |   |     | |   |     |   |   |   | |     | |   | |     |     | | |
+ + +-+ +-+ + +-+-+-+-+-+-+ + +-+ + +-+ +-+-+ + + + +-+-+-+-+ +-+-+ + +-+-+-+-+-+ + +-+ + + +-+-+ + +
|   |       |               |     |         |   |   |         |     |             |     |   |      S 
+-+-+-+-+-+-+-+-+-+-+-+-+-+-+-+-+-+-+-+-+-+-+-+-+-+-+-+-+-+-+-+-+-+-+-+-+-+-+-+-+-+-+-+-+-+-+-+-+-+-+